#####################################################################################################################################
#                                                                                                                                   #
#                                                                                                                                   #
#                                                                                                                                   #
#                                                                                                                                   #
#                                                                                                                                   #
#                                                                                                                                   #
#                                                                                                                                   #
#                                                                                                                                   #
#                                                                                                                                   #
#                                                                                                                                   #
#                                                                                                                                   #
#                                                                                                                                   #
#                                                                                                                                   #
#                                                                                                                                   #
#                                                                                                                                   #
#                                                                                                                                   #
#                                                                                                                                   #
#                                                                                                                                   #
#                                                                                                                                   #
#                                                                                                                                   #
#                                                                                                                                   #
#                                                                                                                                   #
#                                                                                                                                   #
#                                                                                                                                   #
#                                                                                                                                   #
#                                                                                                                                   #
#                                                                                                                                   #
#                                                                                                                                   #
#                                                                                                                                   #
#                                                                                                                                   #
#                                                                                                                                   #
#                                                                                                                                   #
#                                                                                                                                   #
#                                                                                                                                   #
#                                                                                                                                   #
#                                                                                                                                   #
#                                                                                                                                   #
#####################################################################################################################################